SO      ./tex/13.xpm
NO                 ./tex/14.xpm

WE                ./tex/15.xpm
EA     ./tex/12.xpm
F           0, 255, 0
C        0,   255,255






         1111111111111111111111111111111
111111111100000000000000000000011
10000000000000000000000000000011
1000001111110000000000000000001
1000000000000000000000000000001
1000000000000000000000000000001
1000111100000000000000000000001
1000000000000000000000000000001
1000000000010000000000000000001
1000001111100000000000000000001
1000000000000000000000000000001
1000000000000000000000000000001
1000000001110000000000001100001
1000000000000000000000000000001
1000000001110000000000000000001
1000000000000000000000000000001
1000000000000000000N00000000001
1000111100000000000000000000001
1000000000000000000000000000001
1000000000010000000000000000001
1000001111100000000000000000001
1000000000000000000001000000001
100000000000000000001 100000001
1000000001110000000001000000001
1111111111111111111111111111111