SO      ./path_to_the_south_texture
NO               ./path_to_the_north_texture


WE                ./path_to_the_west_texture
EA     ./path_to_the_east_texture
C      111 ,2   ,1   
F           110,        	200,          0



        1111111111111111111111111
        1000000000110000000000001
        1011000001110000000000001
        1001000000000000000000001
111111111011000001110000000000001
100000000011000001110111111111111
11110111111111011100000010001
11110111111111011101010010001
11000111110101011100000010001       111111111
100001  100000001100000010001
10000111100000001101010010N01
1100000111010101111101111000111
11110111 1110101 101111010001
11111111 1111111 111111111111