SO      ./path_to_the_south_texture
NO               ./path_to_the_north_texture





WE                					./path_to_the_west_texture

EA     					./path_to_the_east_texture
F           110,        200,          0
C       225,30,         0






11111111111111111111111
1000000000110000000000001
1011000001110000000000001
1001000000000000000000001
1111111110110000011000001
1000000000110000011101111
1111011111111101110000001
1111011111111101110100001
1100000011010101110000001
1000000000000000110010001
1000000000000000110010001
11000001110101011110S0111
11110111 1110101 10111001
11111111 111111 1111111


